NO game_textures/xpm.xpm
SO game_textures/xpm1.xpm
WE game_textures/xpm2.xpm
EA game_textures/xpm3.xpm


C 83, 60,60
F 83, 60, 61


1111111111111
1000000000001
11100N1011011
1000000000001
1000000000001
1100000000011
1111111111111
