NO game_textures/brick_windows.xpm
SO game_textures/plaster_windows.xpm
WE game_textures/brick_wall.xpm
EA game_textures/brick_ivy.xpm

C 45, 11, 11
F 72, 64, 60

        1111111111111111111111111
        1001000001110000000000001
        1000000000000000000000001
        1001000000000000000000001
11111111011000001110000000000001
10000000001100000111011011111111
1111011111111011100000010001
11110111111111011101010010001
11000000110101011100000010001
100000000E0000001100000010001
100000000000000110101001001
110000111010001111101111000111
11110111 111001 101111010001
11111111 111111 111111111111
1111111 1111111 11111111111
