NO game_textures/green-wall.xpm
SO game_textures/green-wall.xpm
WE game_textures/brick_wall.xpm
EA game_textures/brick_ivy.xpm

C 45, 11, 11
F 72, 64, 60

        1111111111111111111111111
        1001000001110000000000001
        1000000000000000000000001
        1001000000000000000000001
11111111011000001110000000000001
1000000000110000011101101111111111
11110111111110111000000100011111
1111011111111101110101001000111111
110000001101010111000000100011111                       1
10000000E0 0000001100000010001111
1000000000000001101010010011111111
11000011101000111110111100011111111
11110111 111001 1011110111011111111
11111111 111111 1111111111111111111
1111111 1111111 1111111111111111111111111
